*********************
*P..%.%%%%%%%%%%%%%%*
*.#%#.#%#%#%#%#.#.#%*
*%%%%%%.%..%%%.%%%..*
*%#%#.#.#%#.#.#.#.#.*
*.%.%.%.%.%.%.%.%.%.*
*.#.#%#%#%#%#%#.#.#.*
*%%%%%%%%%%%%%..E%..*
*%#%#.#%#.#%#%#.#%#.*
*..%%%%%%%%.%%.%%%..*
*.#%#.#.#%#%#%#.#.#%*
*%%%%%...%%.%..%%..%*
*%#.#%#%#%#%#.#.#.#%*
*%%.%%%%%%%%.%%%%%..*
*%#.#%#%#%#%#%#%#.#.*
*%.%.%%%.%.%.%.%%.%.*
*%#%#%#%#%#%#.#%#.#%*
*%.%.%%%.%.%..%%%%..*
*%#%#%#%#%#%#.#.#.#.*
*%.%%%.%%..%..%.%..P*
*********************