***************
*P.%.......%..*
*..%...%...%..*
*%%*********%%*
*..%%%%%%%%%..*
*..%%%%%%%%%..*
*..%%%%%%%%%..*
*.%%%%E%%%%%%.*
*..%%%%%%%%%..*
*..%%%%%%%%%..*
*..%%%%%%%%%..*
*%%*********%%*
*..%...%...%..*
*..%.......%.P*
***************
