*******
*.....*
*.P%%.*
*.%E%.*
*..**.*
*.....*
*******
