***************
*P..%.%%%%%.%%*
*.#%#.#%#%#%#%*
*%%%%%%.%..%%%*
*%#%#.#.#%#.#.*
*.%.%.%%%%%%%%*
*.#.#%#%#%#%#%*
*%%%%.E%%%%%%%*
*%#%#.#%#.#%#%*
*..%%%%%%%%.%%*
*.#%#.#.#%#%#%*
*%%%%%.%%%%.%%*
*%#.#%#%#%#%#.*
*%.%%%%%%....P*
***************
