###############
#P..%.%%%%%.%%#
#.#%#.#%#%#%#%#
#%%%%%%.%..%%%#
#%#%#.#.#%#.#.#
#.%.%.%%%%%%%%#
#.#.#%#%#%#%#%#
#%%%%..%%%%%%%#
#%#%#.#%#.#%#%#
#..%%%%%%%%.%%#
#.#%#.#.#%#%#%#
#%%%%%.%%%%.%%#
#%#.#%#%#%#%#.#
#%.%%%%%%....P#
###############
